*************
**          *
** **** *** *
** **** *** *
** **** *** *
**E        S*
*************
